Pricing Plans
14 days money back guarantee

MEGA	$10/month	REST API	Daily Limit 1,000	Rate Limit 15/sec	Watermark:No Max Parameter 10	Max Resolution	1920 Ã— 1600


Chart-img-API-KEY=3pJTrvapkk9LQ7FwaUOmf6I354fSOeWa8VJifI2l




https://doc.chart-img.com/#introduction
Base API Endpoint ğŸ”—
https://api.chart-img.com
Authentication ğŸ”’
API v1
For authenticated requests, a personal API key must be included using one of two methods:

Header Authorization: Bearer YOUR_API_KEY
Query Parameter: ?key=YOUR_API_KEY
API v2
For authenticated requests, a personal API key must be included in the header.

Header x-api-key: YOUR_API_KEY
API v3
For authenticated requests, a personal API key must be included in the POST request header x-api-key. For GET requests, the API key can be included in either the request header or as a query parameter named key.

POST/GET Header x-api-key: YOUR_API_KEY
GET Query Parameter: ?key=YOUR_API_KEY
Request Limit âš ï¸
All requests follow typical HTTP response status codes for success, failure, and error.

Rate Limit
The API rate limit is dependent on your plan. If you need a higher request limit and customizations, please contact us for an Enterprise plan.

Plan	req/sec	Burst	Daily max
BASIC	1	3	50
PRO	10	15	500
MEGA	15	25	1,000
ULTRA	35	50	3,000
ENTERPRISE	35+	50+	5,000+
A burst allows an API to temporarily exceed its request rate limit for a short period.

Resolution Limit
The maximum chart image size is dependent on your plan.

Plan	Max width	Max height	Watermark	Custom Watermark
BASIC	800	600	Yes	No
PRO	1920	1080	No	No
MEGA	1920	1600	No	No
ULTRA	2048	1920	No	Yes
ENTERPRISE	2048	1920	No	Yes
Storage Limit
The chart image saved in public storage will expire based on your plan.

Plan	Expire days
BASIC	14
PRO	30
MEGA	60
ULTRA	90
ENTERPRISE	120
Parameter Limit
Starting API v2, the maximum number of parameter objects per request for studies and drawings will depend on your plan.

Plan	Max studies[] + drawings[]
BASIC	3
PRO	5
MEGA	10
ULTRA	25
ENTERPRISE	50
TradingView Symbols
List of supported TradingView exchange symbols. EXCHANGE:SYMBOL

âŒ Chart is not available.
âœ”ï¸ Full & real-time chart is available.
Delayed Full chart is available but may be delayed by a few minutes.
Limited Chart interval availability is limited.
Crypto Currency
Please refer to API v3 Exchange List and Exchange Symbols endpoint to retrieve the latest updates.
Name	API v1/v2	Example
Binance	âœ”ï¸	BINANCE:BTCUSDT
Binance US	âœ”ï¸	BINANCEUS:BTCUSD
BingX	âœ”ï¸	BINGX:BTCUSDT
Biswap (BNB chain)	âœ”ï¸	BISWAP:BFGUSDT_E06259
Bitfinex	âœ”ï¸	BITFINEX:BTCUSD
bitFlyer	âœ”ï¸	BITFLYER:BTCJPY
Bitget	âœ”ï¸	BITGET:BTCUSDT.P
Bithumb	âœ”ï¸	BITHUMB:BTCKRW
BITKUB	âœ”ï¸	BITKUB:KUBTHB
Bitmart	âœ”ï¸	BITMART:BTCUSDT
BitMEX	âœ”ï¸	BITMEX:XBTUSD
Bitrue	âœ”ï¸	BITRUE:FLRUSDT
Bitstamp	âœ”ï¸	BITSTAMP:BTCUSD
Bittrex	âœ”ï¸	BITTREX:DOGEUSD
Blofin	âœ”ï¸	BLOFIN:BTCUSDT.P
Brave New Coin	âœ”ï¸	BNC:BLX
BTSE	âœ”ï¸	BTSE:BTCUSD.P
Bybit	âœ”ï¸	BYBIT:BTCUSDT.P
Coinbase	âœ”ï¸	COINBASE:BTCUSD
CoinEx	âœ”ï¸	COINEX:BTCUSDT
Delta	âœ”ï¸	DELTA:BTCUSDT.P
Derbit	âœ”ï¸	DERIBIT:BTCUSD.P
dYdX	âœ”ï¸	DYDX:ETHUSD
EXMO	âœ”ï¸	EXMO:BTCUSD
Gate.io	âœ”ï¸	GATEIO:APTUSDT
Gemini	âœ”ï¸	GEMINI:BTCUSD
Honeyswap (Polygon)	âœ”ï¸	HONEYSWAPPOLYGON:DAIUSDC
Honeyswap (xDai)	âœ”ï¸	HONEYSWAP:WXDAIMLN
HTX	âœ”ï¸	HTX:BTCUSDT
Kraken	âœ”ï¸	KRAKEN:BTCUSD
KuCoin	âœ”ï¸	KUCOIN:BTCUSDT
MEXC Global	âœ”ï¸	MEXC:BTCUSDT.P
OKCoin	âœ”ï¸	OKCOIN:BTCUSD
OKX	âœ”ï¸	OKX:BTCUSDT.P
Osmosis	âœ”ï¸	OSMOSIS:USDTUSD
PancakeSwap (BNB chain)	âœ”ï¸	PANCAKESWAP:XRPCUSD_4314AC
Pangolin (Avalance)	âœ”ï¸	PANGOLIN:PNGUSDT.E
Phemex	âœ”ï¸	PHEMEX:BTCPERP
Pionex	âœ”ï¸	PIONEX:BTCUSDT.P
Poloniex	âœ”ï¸	POLONIEX:BTCUSDT
Pyth	âœ”ï¸	PYTH:BTCUSD
QuickSwap (Polygon)	âœ”ï¸	QUICKSWAP:OHMDAI
SpookySwap (Fantom)	âœ”ï¸	SPOOKYSWAP:BTCETH_EC454E
SushiSwap (Ethereum)	âœ”ï¸	SUSHISWAP:OHMDAI
SushiSwap (Polygon)	âœ”ï¸	SUSHISWAPPOLYGON:GDDYUSDC
TimeX	âœ”ï¸	TIMEX:QMALLUSDT
Trader Joe (Avalanche)	âœ”ï¸	TRADERJOE:STGUSDC
TradeStation	âœ”ï¸	TRADESTATION:BTCUSD
Uniswap v2 (Ethereum)	âœ”ï¸	UNISWAP:HEXUSDC
Uniswap v3 (Arbitrum)	âœ”ï¸	UNISWAP3ARBITRUM:GMXWETH
Uniswap v3 (Ethereum)	âœ”ï¸	UNISWAP3ETH:XENUSDC
Uniswap v3 (Polygon)	âœ”ï¸	UNISWAP3POLYGON:GNSDAI
UpBit	âœ”ï¸	UPBIT:BTCKRW
Verse (Ethereum)	âœ”ï¸	VERSEETH:WBTCUSDC_F3F82B
Volmex	âœ”ï¸	VOLMEX:BVIV
Wagyuswap (Velas)	âœ”ï¸	WAGYUSWAP:ETHBUSD_63BA88
WhiteBIT	âœ”ï¸	WHITEBIT:WBTUSDT
WOO	âœ”ï¸	WOONETWORK:WOOUSDT
xExchange	âœ”ï¸	XEXCHANGE:ASHUSDC
Zoomex	âœ”ï¸	ZOOMEX:BTCUSDT.P
Name	API v1	API v2	Example
CRYPTOCAP	âœ”ï¸	âœ”ï¸	CRYPTOCAP:TOTAL
Coin Metrics	âŒ	Limited	COINMETRICS:BTC_FEEUSD
Defi Llama	Limited	Limited	DEFILLAMA:SAUCE_TVL
Glassnode	âŒ	Limited	GLASSNODE:BUSD_MARKETCAP
IntoTheBlock	âŒ	Limited	INTOTHEBLOCK:BTC_HASHRATE
Last updated: 2024-02-16

Forex & CFD
Please refer to API v3 Exchange List and Exchange Symbols endpoint to retrieve the latest updates.
Name	API v1/v2	Example
ActivTrades	âœ”ï¸	ACTIVTRADES:EURUSD
Afterprime	âœ”ï¸	AFTERPRIME:EURUSD
BlackBull Markets	âœ”ï¸	BLACKBULL:EURUSD
CAPITALCOM	âœ”ï¸	CAPITALCOM:EURUSD
City Index	âœ”ï¸	CITYINDEX:EURUSD
easyMarkets	âœ”ï¸	EASYMARKETS:EURUSD
Eightcap	âœ”ï¸	EIGHTCAP:EURUSD
FOREX.com	âœ”ï¸	FOREXCOM:EURUSD
FP Markets	âœ”ï¸	FPMARKETS:EURUSD
FXCM	âœ”ï¸	FX:EURUSD
FXOpen	âœ”ï¸	FXOPEN:EURUSD
GBE brokers	âœ”ï¸	GBEBROKERS:EURUSD
IC Markets	âœ”ï¸	ICMARKETS:EURUSD
ICE	âœ”ï¸	ICE:EURUSD
Interactive Brokers	âœ”ï¸	IBKR:EURUSD
JFX	âœ”ï¸	JFX:EURUSD
OANDA	âœ”ï¸	OANDA:EURUSD
Pepperstone	âœ”ï¸	PEPPERSTONE:EURUSD
Phillip Nova	âœ”ï¸	PHILLIPNOVA:EURUSD
Saxo	âœ”ï¸	SAXO:EURUSD
SKILLING	âœ”ï¸	SKILLING:EURUSD
Spreadex	âœ”ï¸	SPREADEX:EURUSD
Velocity Trade	âœ”ï¸	VELOCITY:EURUSD
Last updated: 2024-02-16

Stocks - North America
Please refer to API v3 Exchange List and Exchange Symbols endpoint to retrieve the latest updates.
Name	Country	API v1	API v2	Example
NASDAQ	US	Delayed	âœ”ï¸	NASDAQ:AAPL
NYSE	US	Delayed	âœ”ï¸	NYSE:BABA
NYSE Arca	US	Delayed	âœ”ï¸	AMEX:SPY
OTC	US	Delayed	âœ”ï¸	OTC:GBTC
CSE	CA	Limited	âœ”ï¸	CSE:GTII
NEO	CA	âœ”ï¸	âœ”ï¸	NEO:TSLA
TSX	CA	Delayed	Delayed	TSX:SHOP
TSXV	CA	Delayed	Delayed	TSXV:HIVE
Last updated: 2024-02-16

Stocks - Europe
Please refer to API v3 Exchange List and Exchange Symbols endpoint to retrieve the latest updates.
Name	Country	API v1	API v2	Example
EURONEXT BRUSSELS	BE	âŒ	Delayed	EURONEXT:SOF
SIX	CH	Limited	Delayed	SIX:NESN
BX	CH	âœ”ï¸	âœ”ï¸	BX:AAVE
BER	DE	Limited	âœ”ï¸	BER:CH2A
DUS	DE	Limited	âœ”ï¸	DUS:Q11
FWB	DE	Limited	Delayed	FWB:BY6
GETTEX	DE	âœ”ï¸	âœ”ï¸	GETTEX:TL0
HAM	DE	Limited	âœ”ï¸	HAM:2HP
HAN	DE	Limited	âœ”ï¸	HAN:XS4
MUN	DE	Limited	âœ”ï¸	MUN:5MVW
SWB	DE	Delayed	Delayed	SWB:LHA
TRADEGATE	DE	Delayed	âœ”ï¸	TRADEGATE:TL0
XETR	DE	Limited	Delayed	XETR:ADS
OMXCOP	DK	Delayed	Delayed	OMXCOP:NOVO_B
OMXTSE	EE	Delayed	Delayed	OMXTSE:EGR1T
BME	ES	âŒ	Delayed	BME:SAN
OMXHEX	FI	Delayed	Delayed	OMXHEX:NOKIA
EURONEXT PARIS	FR	âŒ	Delayed	EURONEXT:TTE
ATHEX	GR	Delayed	Delayed	ATHEX:ALPHA
LSE	GB	Limited	Delayed	LSE:RR.
LSIN	GB	Limited	Delayed	LSIN:KAP
TURQUOISE	GB	Delayed	âœ”ï¸	TURQUOISE:RNOP
BET	HU	Delayed	Delayed	BET:OTP
OMXICE	IS	Delayed	Delayed	OMXICE:ICEAIR
MIL	IT	Limited	âœ”ï¸	MIL:JUVE
OMXVSE	LT	Delayed	Delayed	OMXVSE:SAB1L
LUXSE	LU	âŒ	Delayed	LUXSE:LU0006061336
OMXRSE	LV	Delayed	Delayed	OMXRSE:DGR1R
EURONEXT AMSTERDAM	NL	âŒ	Delayed	EURONEXT:ASML
EURONEXT OSLO	NO	âŒ	Delayed	OSL:PGS
GPW	PL	Limited	Delayed	GPW:ALE
NEWCONNECT	PL	Limited	Delayed	NEWCONNECT:MPY
EURONEXT LISBON	PT	âŒ	Delayed	EURONEXT:GALP
BVB	RO	Delayed	Delayed	BVB:TLV
BELEX	RS	âŒ	Limited	BELEX:KRPL
MOEX	RU	âŒ	âœ”ï¸	MOEX:SBER
NGM	SE	âŒ	âœ”ï¸	NGM:ESGR.B
OMXSTO	SE	Delayed	Delayed	OMXSTO:SBB_B
BSSE	SK	âŒ	âŒ	BSSE:1DRS099E
BIST	TR	Limited	Delayed	BIST:THYAO
Last updated: 2024-02-16